11111111111
1000C000001
1011000P001
10000000001
11111000001
1010C001001
1000E000011
1C000000011
11111111111
